0 0 0 0 0 0 0 0 0 0 0 0 0 0 0 0 0 0 0 0 0 0 0 0 0 0 0 0 0 0 0 0 0 0 0 0 0 0 0 0 0 0 0 0 0 0 0 0 0 0 
0 0 0 0 0 0 0 0 0 0 0 0 0 0 0 0 0 0 0 0 0 0 0 0 0 0 0 0 0 0 0 0 0 0 0 0 0 0 0 0 0 0 0 0 0 0 0 0 0 0 
0 0 0 0 0 0 0 0 0 0 0 0 0 0 0 0 0 0 0 0 0 0 0 0 0 0 0 0 0 0 0 0 0 0 0 0 0 0 0 0 0 0 0 0 0 0 0 0 0 0 
0 0 0 0 0 0 0 0 0 0 0 0 0 0 0 0 0 0 0 0 0 0 0 0 0 0 0 0 0 0 0 0 0 0 0 0 0 0 0 0 0 0 0 0 0 0 0 0 0 0 
0 0 0 0 0 0 0 0 0 0 0 0 0 0 0 0 0 0 0 0 0 0 0 0 0 0 0 0 0 0 0 0 0 0 0 0 0 0 0 0 0 0 0 0 0 0 0 0 0 0 
0 0 0 0 0 0 0 0 0 0 0 0 0 0 0 0 0 0 0 0 0 0 0 0 0 0 0 0 0 0 0 0 0 0 0 0 0 0 0 0 0 0 0 0 0 0 0 0 0 0 
0 0 0 0 0 0 32 32 32 32 32 32 32 32 32 32 32 32 32 32 32 32 32 32 32 32 32 32 32 32 32 32 32 32 32 32 32 32 32 32 32 32 32 32 0 0 0 0 0 0 
0 0 0 0 0 0 32 32 32 32 32 32 32 32 32 32 32 32 32 32 32 32 32 32 32 32 32 32 32 32 32 32 32 32 32 32 32 32 32 32 32 32 32 32 0 0 0 0 0 0 
0 0 0 0 0 0 32 32 32 32 32 32 32 32 32 32 32 32 32 32 32 32 32 32 32 32 32 32 32 32 32 32 32 32 32 32 32 32 32 32 32 32 32 32 0 0 0 0 0 0 
0 0 0 0 0 0 32 32 32 17 17 17 17 17 32 38 39 17 17 17 17 17 17 17 17 17 17 17 17 17 17 17 17 17 17 17 17 17 17 17 17 32 32 32 0 0 0 0 0 0 
0 0 0 0 0 0 32 32 32 17 17 17 17 17 32 39 17 17 17 17 17 17 17 17 17 17 17 17 17 17 17 17 32 32 32 32 32 32 32 17 17 32 32 32 0 0 0 0 0 0 
0 0 0 0 0 0 32 32 32 17 17 37 17 17 32 17 17 17 32 32 32 32 32 32 32 32 32 32 32 32 17 17 32 32 32 32 32 32 32 17 17 32 32 32 0 0 0 0 0 0 
0 0 0 0 0 0 32 32 32 17 17 17 17 17 32 17 17 17 32 32 32 32 32 32 32 32 32 32 32 32 17 17 32 32 17 17 17 17 32 17 17 32 32 32 0 0 0 0 0 0 
0 0 0 0 0 0 32 32 32 17 17 17 17 17 32 17 17 17 17 17 17 17 17 17 17 17 17 17 17 32 17 17 32 32 17 17 17 17 17 17 17 32 32 32 0 0 0 0 0 0 
0 0 0 0 0 0 32 32 32 17 17 32 32 32 32 17 17 17 17 17 17 17 17 17 17 17 17 17 17 32 17 17 32 32 17 17 17 17 32 17 17 32 32 32 0 0 0 0 0 0 
0 0 0 0 0 0 32 32 32 17 17 32 17 17 17 17 17 17 32 32 32 32 32 32 32 32 32 32 32 32 17 17 32 32 32 32 32 32 32 17 17 32 32 32 0 0 0 0 0 0 
0 0 0 0 0 0 32 32 32 17 17 32 17 17 17 17 17 17 17 17 17 17 17 17 17 17 17 17 17 32 17 17 17 32 32 32 32 32 32 17 17 32 32 32 0 0 0 0 0 0 
0 0 0 0 0 0 32 32 32 17 17 32 17 17 17 17 17 17 17 17 17 17 17 17 17 17 17 17 17 32 32 17 17 32 17 17 39 17 32 17 17 32 32 32 0 0 0 0 0 0 
0 0 0 0 0 0 32 32 32 17 17 32 32 32 32 32 32 32 32 32 32 32 32 32 32 32 32 17 17 39 32 17 17 32 17 17 17 17 17 17 17 32 32 32 0 0 0 0 0 0 
0 0 0 0 0 0 32 32 32 17 17 17 17 17 17 17 17 17 17 17 17 17 17 17 17 17 32 17 40 40 32 17 17 32 17 17 17 17 32 17 17 32 32 32 0 0 0 0 0 0 
0 0 0 0 0 0 32 32 32 17 17 17 17 17 17 17 17 17 17 17 17 17 17 17 17 17 32 40 38 40 32 17 17 32 32 32 32 32 32 17 17 32 32 32 0 0 0 0 0 0 
0 0 0 0 0 0 32 32 32 32 32 32 32 32 32 32 32 32 32 32 32 32 32 32 17 17 32 41 40 39 32 17 17 32 32 32 32 32 32 17 17 32 32 32 0 0 0 0 0 0 
0 0 0 0 0 0 32 32 32 32 32 32 32 32 32 32 32 32 32 32 32 32 32 32 17 17 32 32 32 32 32 17 17 32 17 17 17 17 32 17 17 32 32 32 0 0 0 0 0 0 
0 0 0 0 0 0 32 32 32 32 32 32 32 32 32 32 32 32 32 32 32 32 32 32 17 17 17 17 17 17 17 17 17 32 17 17 17 17 17 17 17 32 32 32 0 0 0 0 0 0 
0 0 0 0 0 0 32 32 32 17 17 17 17 17 17 17 17 17 17 17 17 32 32 32 17 17 17 17 17 17 17 17 17 32 17 39 17 17 32 17 17 32 32 32 0 0 0 0 0 0 
0 0 0 0 0 0 32 32 32 17 17 17 17 40 39 17 17 17 17 17 17 32 32 32 32 32 32 32 32 32 32 17 17 32 32 32 32 32 32 17 17 32 32 32 0 0 0 0 0 0 
0 0 0 0 0 0 32 32 32 17 17 17 41 40 40 40 17 17 17 17 17 32 32 32 32 32 32 32 32 32 32 17 17 32 32 32 32 32 32 17 17 32 32 32 0 0 0 0 0 0 
0 0 0 0 0 0 32 32 32 17 17 17 40 40 38 40 17 17 17 17 17 17 17 17 17 17 17 17 17 17 32 17 17 32 17 17 17 38 32 17 17 32 32 32 0 0 0 0 0 0 
0 0 0 0 0 0 32 32 32 17 17 17 40 38 40 40 17 17 17 17 17 32 32 17 17 17 17 17 17 17 32 17 17 32 17 17 17 17 17 17 17 32 32 32 0 0 0 0 0 0 
0 0 0 0 0 0 32 32 32 17 17 17 39 40 41 40 17 17 17 17 17 32 32 32 32 32 32 32 17 17 32 17 17 32 17 17 17 17 32 17 17 32 32 32 0 0 0 0 0 0 
0 0 0 0 0 0 32 32 32 17 17 17 17 40 40 17 17 17 17 17 17 32 32 32 32 32 32 32 17 17 32 17 17 32 32 32 32 32 32 17 17 32 32 32 0 0 0 0 0 0 
0 0 0 0 0 0 32 32 32 17 17 17 17 17 17 17 17 17 17 17 17 32 32 40 40 41 32 32 17 17 32 17 17 32 32 32 32 32 32 17 17 32 32 32 0 0 0 0 0 0 
0 0 0 0 0 0 32 32 32 32 32 32 32 32 32 32 32 32 32 32 32 32 32 39 40 40 32 32 17 17 32 17 17 32 41 17 17 17 32 17 17 32 32 32 0 0 0 0 0 0 
0 0 0 0 0 0 32 32 32 32 32 32 32 32 32 32 32 32 32 32 32 32 32 17 38 17 32 32 17 32 32 32 32 32 17 17 17 17 17 17 17 32 32 32 0 0 0 0 0 0 
0 0 0 0 0 0 32 32 32 38 39 17 17 17 17 17 17 17 17 17 17 32 32 17 17 17 32 32 17 32 32 32 32 32 17 17 17 17 32 17 17 32 32 32 0 0 0 0 0 0 
0 0 0 0 0 0 32 32 32 39 17 17 17 17 17 17 17 17 17 36 17 32 32 17 17 17 32 32 17 17 17 17 32 32 32 32 32 32 32 17 17 32 32 32 0 0 0 0 0 0 
0 0 0 0 0 0 32 32 32 17 17 17 17 17 17 17 17 17 17 17 17 32 32 17 17 17 32 32 17 17 17 17 32 32 32 32 32 32 32 17 17 32 32 32 0 0 0 0 0 0 
0 0 0 0 0 0 32 32 32 17 32 32 32 32 32 32 32 32 32 32 32 32 32 17 17 17 32 32 17 17 17 17 32 32 17 17 17 17 17 17 17 32 32 32 0 0 0 0 0 0 
0 0 0 0 0 0 32 32 32 17 32 32 32 32 32 32 32 32 32 32 32 32 32 17 17 17 32 32 17 17 17 17 32 32 17 17 17 17 17 17 17 32 32 32 0 0 0 0 0 0 
0 0 0 0 0 0 32 32 32 17 17 17 17 17 17 17 17 17 17 17 17 17 17 17 17 17 17 17 17 17 17 17 32 32 17 17 17 17 17 17 17 32 32 32 0 0 0 0 0 0 
0 0 0 0 0 0 32 32 32 17 17 17 17 17 17 17 17 17 17 17 17 17 17 17 17 17 17 17 17 17 17 17 17 17 17 17 17 17 17 17 17 32 32 32 0 0 0 0 0 0 
0 0 0 0 0 0 32 32 32 32 32 32 32 32 32 32 32 32 32 32 32 32 32 32 32 32 32 32 32 32 32 32 32 32 32 32 32 32 32 32 32 32 32 32 0 0 0 0 0 0 
0 0 0 0 0 0 32 32 32 32 32 32 32 32 32 32 32 32 32 32 32 32 32 32 32 32 32 32 32 32 32 32 32 32 32 32 32 32 32 32 32 32 32 32 0 0 0 0 0 0 
0 0 0 0 0 0 32 32 32 32 32 32 32 32 32 32 32 32 32 32 32 32 32 32 32 32 32 32 32 32 32 32 32 32 32 32 32 32 32 32 32 32 32 32 0 0 0 0 0 0 
0 0 0 0 0 0 0 0 0 0 0 0 0 0 0 0 0 0 0 0 0 0 0 0 0 0 0 0 0 0 0 0 0 0 0 0 0 0 0 0 0 0 0 0 0 0 0 0 0 0 
0 0 0 0 0 0 0 0 0 0 0 0 0 0 0 0 0 0 0 0 0 0 0 0 0 0 0 0 0 0 0 0 0 0 0 0 0 0 0 0 0 0 0 0 0 0 0 0 0 0 
0 0 0 0 0 0 0 0 0 0 0 0 0 0 0 0 0 0 0 0 0 0 0 0 0 0 0 0 0 0 0 0 0 0 0 0 0 0 0 0 0 0 0 0 0 0 0 0 0 0 
0 0 0 0 0 0 0 0 0 0 0 0 0 0 0 0 0 0 0 0 0 0 0 0 0 0 0 0 0 0 0 0 0 0 0 0 0 0 0 0 0 0 0 0 0 0 0 0 0 0 
0 0 0 0 0 0 0 0 0 0 0 0 0 0 0 0 0 0 0 0 0 0 0 0 0 0 0 0 0 0 0 0 0 0 0 0 0 0 0 0 0 0 0 0 0 0 0 0 0 0 
0 0 0 0 0 0 0 0 0 0 0 0 0 0 0 0 0 0 0 0 0 0 0 0 0 0 0 0 0 0 0 0 0 0 0 0 0 0 0 0 0 0 0 0 0 0 0 0 0 0 
